1111111111111
13010000003C1
1000011111001
1P0011E000001
1111111111111